TILEMAP
36 28 							-- Size of tile map in tiles
16 16							-- Tile size & block size
images/spr_Greenlands_orth_0.png 	-- Tilesheet
13 7 								-- Number of tiles in tilesheet
000000000000000000000000000000000000
000000000000000000000000000000000000
000000000000000000000000000000000000
000000000000000000000000000000000000
000000000000000000000000000000000000
000122222222222222222222222223000000
000>?????????????????????????@000000
000K                         M000000
000K                         M000000
000K                         M000000
000K                         M000000
000K                         M000000
000XYYYYYYYYYYYYYYYYYYYYYYYYYY000000
000000000000000000000000000000000000
000000000000000000000000000000000000
000000000000000000000000000000000000
000000000000000000000000000000000000
000000000000000000000000000000000000
000000000000000000000000000000000000
000000000000000000000000000000000000
000000000000000000000000000000000000
000000000000000000000000000000000000
000000000000000000000000000000000000
000000000000000000000000000000000000
000000000000000000000000000000000000
000000000000000000000000000000000000
000000000000000000000000000000000000
000000000000000000000000000000000000

