TILEMAP
36 28 							-- Size of tile map in tiles
16 16							-- Tile size & block size
images/spr_Greenlands_orth_0.png 	-- Tilesheet
13 7 								-- Number of tiles in tilesheet
122222222222222222222222223000000000
>?????????????????????????@000000000
K                         M000000000
K                         M000000000
K                         M000000000
K                         M000000000
K                         M000000000
K       MYYYYYYYYYYYYYYYYYY000000000
K       M012222222222222223000000000
K       M0>???????????????@000000000
K       M0K               M000000000
K       M0K               M000000000
K       M0K               M000000000
K       M0K               M000000000
K       M0K               M000000000
K       M0K               M000000000
K       M0K               M000000000
K       M0K               M000000000
K       M0K               M000000000
K       M0K               M000000000
K       M0K               M000000000
K       M0K               M000000000
K       M0K               M000000000
K       M0K               M000000000
K       M0K               M000000000
K       M0XYYYYYYYYYYYYYYYZ000000000
K       M0QRRRRRRRRRRRRRRRS000000000
XYYYYYYYZ0NOOOOOOOOOOOOOOOP000000000

